Abject - adjective - : sunk to or existing in a low state or condition : very bad or severe or : cast down in spirit : servile, spiritless

Aberration - noun - : the fact or an instance of deviating or being aberrant especially from a moral standard or normal state or : something or someone regarded as atypical and therefore able to be ignored or discounted

Abjure - verb - : to renounce upon oath or : to reject solemnly

Abnegation - noun - : denial

Abrogate - verb - : to abolish by authoritative action : annul or : to treat as nonexistent : to fail to do what is required by (something, such as a responsibility)

Abscond - verb - : to depart secretly and hide oneself or : to depart secretly : withdraw and hide oneself

Abstruse - adjective - : difficult to comprehend : recondite

Accede - verb - : to express approval or give consent : to agree to a request or demand or : to become a party to something (such as an agreement)

Accretion - noun - : the process of growth or enlargement by a gradual buildup: such as or : increase by external addition or accumulation (as by adhesion of external parts or particles)

Acumen - noun - : keenness and depth of perception, discernment, or discrimination especially in practical matters or : the ability to think clearly and make good decisions

Adament - error - 

Admonish - verb - : to indicate duties or obligations to or : to express warning or disapproval to especially in a gentle, earnest, or solicitous manner

Adumbrate - verb - : to foreshadow vaguely : intimate or : to suggest, disclose, or outline partially

Adverse - adjective - : acting against or in a contrary direction : hostile or : opposed to one's interests

Advocate - noun - : one who pleads the cause of another or : one who defends or maintains a cause or proposal

Affluent - adjective - : having an abundance of goods or riches : wealthy or : flowing in abundance

Aggrandize - verb - : to make great or greater : increase, enlarge or : to make appear great or greater : praise highly

Alacrity - noun - : promptness in response : cheerful readiness or : a quick and cheerful readiness to do something

Alias - adverb - : otherwise called : otherwise known as or : an assumed or additional name that a person (such as a criminal) sometimes uses

Ambivalent - adjective - : having or showing simultaneous and contradictory attitudes or feelings toward something or someone : characterized by ambivalence or : having or showing very different feelings (such as love and hate) about someone or something at the same time

amenable - adjective - : liable to be brought to account : answerable or : capable of submission (as to judgment or test) : suited

amorphous - adjective - : having no definite form : shapeless or : being without definite character or nature : unclassifiable

anachronistic - noun - : an error in chronology or : a person or a thing that is chronologically out of place

anathema - noun - : someone or something intensely disliked or loathed or : one that is cursed by ecclesiastical authority

annex - verb - : to attach as a quality, consequence, or condition or : to join together materially : unite

antediluvian - adjective - : of or relating to the period before the flood described in the Bible or : made, evolved, or developed a long time ago

antiseptic - adjective - : opposing microbial infection or : relating to or characterized by the use of antiseptic substances

apathetic - adjective - : affected by, characterized by, or displaying apathy : having or showing little or no interest, concern, or emotion or : not having or showing much emotion or interest

antithesis - noun - : the direct opposite or : the rhetorical contrast of ideas by means of parallel arrangements of words, clauses, or sentences (as in "action, not words" or "they promised freedom and provided slavery")

apocryphal - adjective - : of doubtful authenticity : spurious or : of or resembling the Apocrypha

approbation - noun - : commendation, praise or : an act of approving formally or officially

arbitrary - adjective - : existing or coming about seemingly at random or by chance or as a capricious and unreasonable act of will or : based on or determined by individual preference or convenience rather than by necessity or the intrinsic nature of something

arboreal - adjective - : of, relating to, or resembling a tree or : inhabiting or frequenting trees

arcane - adjective - : known or knowable only to a few people : secret

archetypal - noun - : the original pattern or model of which all things of the same type are representations or copies : prototype or : 

arrogate - verb - : to claim or seize without justification or : to make undue claims to having : assume

Enervate - adjective - : lacking physical, mental, or moral vigor : enervated or : to reduce the mental or moral vigor of

Enfranchise - verb - : to set free (as from slavery) or : to endow with a franchise: such as

Engender - verb - : beget, procreate or : to cause to exist or to develop : produce

Ephemeral - adjective - : lasting a very short time or : lasting one day only

Epistolary - adjective - : of, relating to, or suitable to a letter or : contained in or carried on by letters

Equanimity - noun - : evenness of mind especially under stress or : right disposition : balance

Equivocal - adjective - : subject to two or more interpretations and usually used to mislead or confuse or : uncertain as an indication or sign

Espouse - verb - : marry or : to take up and support as a cause : become attached to

Evanescent - adjective - : tending to vanish like vapor or : lasting a very short time

Evince - verb - : to constitute outward evidence of or : to display clearly : reveal

Exacerbate - verb - : to make more violent, bitter, or severe or : to make (a bad situation, a problem, etc.) worse

Exhort - verb - : to incite by argument or advice : urge strongly or : to give warnings or advice : make urgent appeals

Execrable - adjective - : deserving to be execrated : detestable or : very bad : wretched

Exigent - adjective - : requiring immediate aid or action or : requiring or calling for much : demanding

Expedient - adjective - : suitable for achieving a particular end in a given circumstance or : characterized by concern with what is opportune

Expiate - verb - : to make amends for or : to extinguish the guilt incurred by

Expunge - verb - : to strike out, obliterate, or mark for deletion or : to efface completely : destroy

Extraneous - adjective - : existing on or coming from the outside or : not forming an essential or vital part

Extol - verb - : to praise highly : glorify or : to praise (someone or something) highly

Extant - adjective - : currently or actually existing or : still existing : not destroyed or lost

Expurgate - verb - : to cleanse of something morally harmful, offensive, or erroneous or : to change (a written work) by removing parts that might offend people

Fallacious - adjective - : embodying a fallacy or : tending to deceive or mislead : delusive

Fatuous - adjective - : complacently or inanely foolish : silly or : foolish or stupid

Fetter - noun - : a chain or shackle for the feet or : something that confines : restraint

Flagrant - adjective - : conspicuously offensive or : fiery hot : burning

Foil - verb (1) - : to prevent from attaining an end : defeat or : to bring to naught : thwart

Forbearance - noun - : a refraining from the enforcement of something (such as a debt, right, or obligation) that is due or : the act of forbearing : patience

Fortuitous - adjective - : occurring by chance or : fortunate, lucky

Fractious - adjective - : tending to be troublesome : unruly or : quarrelsome, irritable

Garrulous - adjective - : given to prosy, rambling, or tedious loquacity : pointlessly or annoyingly talkative or : 

Gourmand - noun - : one who is excessively fond of eating and drinking or : one who is heartily interested in good food and drink

Grandiloquent - noun - : a lofty, extravagantly colorful, pompous, or bombastic style, manner, or quality especially in language

Gratuitous - adjective - : not called for by the circumstances : not necessary, appropriate, or justified : unwarranted or : given unearned or without recompense

Hapless - adjective - : having no luck : unfortunate or : having no luck : very unfortunate

Hegemony - noun - : preponderant influence or authority over others : domination or : the social, cultural, ideological, or economic influence exerted by a dominant group

Heterogenous - adjective - : heterogeneous or : originating in an outside source

Iconoclast - noun - : a person who attacks settled beliefs or institutions or : a person who destroys religious images or opposes their veneration

Idiosyncratic - noun - : a peculiarity of constitution or temperament : an individualizing characteristic or quality or : individual hypersensitiveness (as to a drug or food)

Impecunious - adjective - : having very little or no money usually habitually : penniless or : having little or no money

Impetuous - adjective - : marked by impulsive vehemence or passion or : marked by force and violence of movement or action

Impinge - verb - : encroach, infringe or : to have an effect : make an impression

Impute - verb - : to lay the responsibility or blame for (something) often falsely or unjustly or : to credit or ascribe (something) to a person or a cause : attribute

Inane - adjective - : lacking significance, meaning, or point : silly or : empty, insubstantial

Inchoate - adjective - : being only partly in existence or operation : incipient or : not completely formed or developed yet

Incontrovertible - adjective - : not open to question : indisputable or : not able to be doubted or questioned

Incumbent - noun - : the holder of an office or ecclesiastical benefice or : one that occupies a particular position or place

Inexorable - adjective - : not to be persuaded, moved, or stopped : relentless or : not able to be stopped or changed

Inimical - adjective - : being adverse often by reason of hostility or malevolence or : having the disposition of an enemy : hostile

Injunction - noun - : a writ granted by a court of equity whereby one is required to do or to refrain from doing a specified act or : the act or an instance of enjoining : order, admonition

Inoculate - verb - : to introduce immunologically active material (such as an antibody or antigen) into especially in order to treat or prevent a disease or : to introduce a microorganism into

Insidious - adjective - : having a gradual and cumulative effect : subtle or : developing so gradually as to be well established before becoming apparent

Instigate - verb - : to goad or urge forward : provoke or : to cause (something) to happen or begin

Insurgent - noun - : a person who revolts against civil authority or an established government or : one who acts contrary to the policies and decisions of one's own political party

Interlocutor - noun - : one who takes part in dialogue or conversation or : a man in the middle of the line in a minstrel show who questions the end men and acts as leader

Intimation - noun - : an indirect, usually subtle suggestion, indication, or hint

Inure - verb - : to accustom to accept something undesirable or : to become of advantage

Invective - noun - : insulting or abusive language : vituperation or : an abusive expression or speech

Intransigent - adjective - : characterized by refusal to compromise or to abandon an often extreme position or attitude : uncompromising or : completely unwilling to change : very stubborn

Inveterate - adjective - : confirmed in a habit : habitual or : firmly established by long persistence

Irreverence
 - noun - : lack of reverence or : an irreverent act or utterance